NO       ./file.xpm
SO      ./popo.xpm      

WE     ./skrrr.xpm  


EA      ./grr.xpm              

F        100,10,0

C        225     ,     30  ,   0   


1111111111111111111111111
1111111111111111111111111
1000000000110000000000001
101100000111000000000000111
1001000000111100000000000111111111
11111111101010000011101001
1111111111111111111111111          
111111111111111111111111111111
100000000011100001010110101111111
111101111101110000001011111
111101111W0111010100100011111
110000001100010111000000001001
10000000000000001100000010001
10000000000000001101010010001
11000001110101011111011110000111
11110111 1110101 101111010001
11111111 1111111 111111111111
     



