NO       ./file.xpm
SO      ./popo.xpm           
WE     ./skrrr.xpm          
EA      ./grr.xpm              

F        100,10,0

C        225     ,     30  ,   0          


1111111111011111111111111
1000000000110000000000001
101100000111000000000000111
100100000000000000000000111111111
111111111011000001110000000000001
100000000011000001010111111111111      1
1111011111011100000010001
111101111W011101010010001
11000000110001011100000010001
10000000000000001100000010001
10000000000000001101010010001
1100000111010101111101111000111
11110111 1110101 101111010001
11111111 1111111 111111111111